DATASET: lymphography
displaced, yes, no, no, no, no, no, yes, 1, 2, oval, lacunar, lac_central, faint, no, no, yes, 2, malign_lymph	 Predicted: metastases -> FAIL
arched, yes, no, no, no, yes, no, yes, 1, 4, round, lac_central, lac_central, faint, vesicles, yes, yes, 7, malign_lymph	 Predicted: malign_lymph -> HIT
arched, no, no, no, no, no, no, yes, 1, 3, oval, lac_central, lac_central, coarse, vesicles, yes, yes, 5, malign_lymph	 Predicted: malign_lymph -> HIT
deformed, yes, no, no, no, no, no, no, 1, 2, oval, lac_margin, lac_margin, drop_like, vesicles, no, no, 2, metastases	 Predicted: metastases -> HIT
displaced, yes, yes, no, yes, yes, no, yes, 1, 3, round, lac_central, lac_margin, faint, chalices, yes, yes, 3, metastases	 Predicted: metastases -> HIT
deformed, no, no, no, no, yes, no, yes, 1, 4, oval, lac_central, lac_central, grainy, vesicles, yes, yes, 3, malign_lymph	 Predicted: malign_lymph -> HIT
deformed, no, no, no, no, no, yes, no, 1, 2, oval, lac_central, lac_margin, diluted, chalices, no, yes, 1, metastases	 Predicted: metastases -> HIT
deformed, yes, no, no, no, yes, no, yes, 1, 2, oval, lacunar, lacunar, no, vesicles, no, no, 1, metastases	 Predicted: metastases -> HIT
displaced, no, no, no, no, no, no, yes, 1, 4, oval, lacunar, lac_central, stripped, vesicles, yes, yes, 7, malign_lymph	 Predicted: malign_lymph -> HIT
deformed, yes, no, no, no, yes, no, yes, 1, 3, oval, lac_central, lac_margin, coarse, chalices, yes, yes, 2, metastases	 Predicted: metastases -> HIT
arched, no, no, no, no, no, no, no, 1, 1, oval, lac_central, lac_margin, faint, chalices, yes, yes, 2, metastases	 Predicted: metastases -> HIT
arched, yes, no, no, no, no, no, no, 1, 2, oval, lac_margin, lac_margin, diluted, chalices, yes, yes, 1, metastases	 Predicted: metastases -> HIT
arched, yes, no, no, no, yes, no, yes, 1, 2, round, lac_margin, lac_margin, diluted, vesicles, yes, yes, 1, metastases	 Predicted: metastases -> HIT
displaced, no, no, no, no, yes, no, yes, 1, 4, round, lac_central, lacunar, diluted, vesicles, yes, yes, 2, malign_lymph	 Predicted: malign_lymph -> HIT
displaced, yes, yes, yes, yes, yes, yes, yes, 1, 4, round, lac_central, lac_central, stripped, vesicles, yes, yes, 8, malign_lymph	 Predicted: malign_lymph -> HIT
displaced, yes, yes, yes, yes, yes, no, yes, 1, 4, round, lac_central, lac_central, stripped, vesicles, yes, yes, 6, malign_lymph	 Predicted: malign_lymph -> HIT
deformed, no, no, no, no, no, no, no, 1, 2, oval, lacunar, lacunar, diluted, no, no, yes, 2, malign_lymph	 Predicted: metastases -> FAIL
arched, yes, no, no, no, yes, no, yes, 1, 2, round, lac_margin, lac_margin, diluted, vesicles, yes, yes, 2, metastases	 Predicted: metastases -> HIT
arched, no, no, no, no, yes, no, yes, 1, 3, round, lacunar, lacunar, coarse, vesicles, yes, yes, 6, malign_lymph	 Predicted: malign_lymph -> HIT
deformed, yes, yes, no, no, yes, no, no, 1, 2, round, lac_margin, lac_margin, diluted, chalices, no, yes, 2, metastases	 Predicted: metastases -> HIT
arched, no, no, no, no, no, no, yes, 1, 3, oval, lacunar, lacunar, faint, vesicles, yes, yes, 5, malign_lymph	 Predicted: malign_lymph -> HIT
deformed, yes, yes, yes, yes, yes, no, yes, 1, 2, round, lac_margin, lac_margin, coarse, vesicles, yes, yes, 7, metastases	 Predicted: malign_lymph -> FAIL
arched, yes, no, no, no, no, no, no, 1, 1, oval, lacunar, lac_margin, drop_like, no, no, no, 1, metastases	 Predicted: metastases -> HIT
displaced, yes, no, no, yes, yes, no, no, 1, 1, round, lac_margin, lac_margin, drop_like, vesicles, yes, yes, 3, metastases	 Predicted: normal -> FAIL
displaced, no, no, no, no, no, no, yes, 1, 3, round, lacunar, lacunar, coarse, chalices, yes, yes, 2, metastases	 Predicted: metastases -> HIT
normal, no, no, no, no, no, no, no, 1, 1, bean, no, no, no, no, no, no, 1, normal	 Predicted: normal -> HIT
arched, yes, no, no, no, yes, no, yes, 1, 3, round, lac_central, lacunar, faint, vesicles, yes, yes, 2, malign_lymph	 Predicted: malign_lymph -> HIT
displaced, yes, no, no, yes, yes, no, yes, 1, 3, round, lac_central, lac_margin, coarse, vesicles, yes, yes, 2, metastases	 Predicted: metastases -> HIT
displaced, yes, no, no, yes, yes, no, yes, 1, 2, round, lacunar, lac_margin, grainy, vesicles, yes, yes, 4, metastases	 Predicted: metastases -> HIT
deformed, yes, yes, yes, yes, yes, yes, no, 2, 2, oval, lac_central, lacunar, coarse, vesicles, yes, yes, 7, fibrosis	 Predicted: malign_lymph -> FAIL